XXXXXXXXXXXXXXXXXXXXXXXXXXXXXX
X..$$$$$$$$$..XXXXXXXXXXXXXXXX
X..$.......$..XXXXXXXXXXXXXXXX
X..$.......$..XXXXXXXXXXXXXXXX
X..$TTTTTTT...XXXXXXXXXXXXXXXX
X....TTTTT....XXXXXXXXXXXXXXXX
X.....TTT.....XXXXXXXXXXXXXXXX
X......T......XXXXXXXXXXXXXXXX
X..$$$$$$$$$..XXXXXXXXXXXXXXXX
X...TTTTTTT...XXXXXXXXXXXXXXXX
X....TTTTT....XXXXXXXXXXXXXXXX

