XTTTTTTT...............TXXXTTT
XXXXXXXXXXXXXXXX.............T
T.T.....f.............TTT...$T
T.$.....f...........T........T
T...@...XXXXXXXXXXXXXX.......T
T..........$...............T.T
T.......................TTT..T
TXXXXXXXXXXXXXXXX........TT.TT
T...............X............T
T..XXXXXXXXX....X..........TTT
TTTTTTTTTTTTTTTTTTTTTTTTTTTTTT

